+---+---+---+---+---+---+---+---+---+---+---+---+---+---+---+---+---+---+---+---+
                |       |                                   |           |       |
+   +   +   +---+   +   +   +---+   +   +---+   +---+   +---+   +   +---+   +   +
|           |       |       |   |           |       |           |           |   |
+   +   +---+   +---+---+---+   +   +---+   +---+   +   +---+---+   +---+---+   +
|   |           |       |                           |   |                       |
+   +---+   +   +   +   +---+   +---+---+   +---+   +   +   +---+   +---+   +   +
|   |                                               |           |               |
+   +   +---+   +   +---+   +---+---+   +---+   +   +   +---+   +   +---+---+---+
|                                                               |               |
+---+   +   +   +   +---+---+---+   +---+   +---+---+---+---+   +   +   +   +   +
|   |           |   |           |               |                   |   |   |   |
+   +   +   +---+   +   +   +   +   +---+   +   +   +---+---+---+   +---+   +   +
|       |   |   |       |       |   |       |   |   |                       |   |
+   +---+   +   +   +---+   +---+---+   +   +---+   +   +   +   +---+   +---+   +
|   |       |               |       |   |                   |               |   |
+---+   +---+   +   +---+   +   +   +   +   +---+   +   +   +   +   +   +   +   +
|       |               |   |   |       |   |                       |   |       |
+   +---+   +   +---+   +   +   +   +---+---+   +   +   +   +   +   +   +---+---+
|   |       |       |       |           |               |   |               |   |
+   +   +---+   +   +   +   +   +   +   +   +---+   +---+   +---+---+   +   +   +
|       |           |       |   |       |       |       |                       |
+---+---+   +---+---+   +---+---+   +---+   +   +   +---+---+---+   +   +---+   +
|           |       |       |               |   |               |       |       |
+   +---+   +   +   +---+   +   +   +   +---+   +   +---+   +   +   +   +---+   +
|   |           |               |                   |               |       |   |
+   +   +---+---+   +---+---+---+   +   +   +---+---+   +   +   +   +   +   +   +
|   |   |       |   |       |                           |   |       |   |   |   |
+   +   +   +   +   +   +   +   +---+---+   +---+   +---+   +   +   +---+   +   +
|   |       |   |       |       |                               |   |       |   |
+   +   +---+   +   +   +   +   +   +   +---+---+   +   +---+   +   +   +---+   +
|       |       |       |       |   |           |       |       |       |       |
+   +---+   +   +---+   +---+   +---+   +   +   +---+---+---+---+---+---+   +---+
|       |           |   |           |       |   |                       |       |
+---+   +   +   +   +   +   +   +   +   +   +   +   +---+   +   +---+   +---+   +
|   |   |   |       |   |   |   |           |               |                   |
+   +   +   +---+---+   +   +   +---+   +   +---+---+   +   +   +   +---+---+---+
|   |   |                       |       |           |   |   |       |       |   |
+   +   +---+---+   +---+---+---+   +   +---+   +   +   +---+   +---+   +   +   +
|               |                   |               |                   |       
+---+---+---+---+---+---+---+---+---+---+---+---+---+---+---+---+---+---+---+---+
